NO ./textures/greystone.xpm
SO ./textures/bluestone.xpm
WE ./textures/mossy.xpm
EA ./textures/redstone.xpm
F 220,100,0
C 225,30,0
  
111111
110001
1DN001
110001
111111