NO ./textures/greystone.xpm
SO ./textures/bluestone.xpm
WE ./textures/mossy.xpm
EA ./textures/redstone.xpm
F 220,100,0
C 225,30,0
  
11111111111
1001   111111
1010   11111
1100N1  1111
111111111
111