NO ./textures/greystone.xpm
SO ./textures/bluestone.xpm
WE ./textures/mossy.xpm
EA ./textures/redstone.xpm
F 220,100,0
C 225,30,0

111111111111111111111

100101111111111011111
1010000000000000111
1100W1111110011111111
11111111100000111111
111111110000000111111
1111111000000000111111
111111110000000111111
11111111100000111111
1110011111000111111
111001111110111111
11100000000011111
1111111111111111
1111111111111
      111111
