NO ./textures/greystone.xpm
SO ./textures/redstone.xpm
WE ./textures/wood.xpm
EA ./textures/purplestone.xpm
F 192,192,192
C 105,105,105

        1111111111111111111111111
        1000000000110000000000001
        1011000001110000000000001
        100100000000000000W000001
111111111011000001110000000000001
10000000001100000111011111D111111
11110111111111011100000010001
11110111111111011101010010001
11000000110101011100000010001
10000000000000001100000010001
10000000000000001101010010001
110000011101010111D1011D1000111
11110111 1110101 101111010001
11111111 1111111 111111111111