NO ./textures/greystone.xpm
SO ./textures/bluestone.xpm
WE ./textures/mossy.xpm
EA ./textures/redstone.xpm
F 192,192,192
C 105,105,105

     1111111
      10001
      10001
      10001
      10001
      10001
      10001
      10001
      10001
      10001
      10001
      10001
 111111101111111
 100001000100001
 100000000000001
 100001000100001
 100001000100001
 111111000111111
 100001000100001
 1E0000000000001
 100001000100001
 111111000111111
 100000000000001
 100000000000001
 100000000000001
 111111111111111
