NO ./textures/greystone.xpm
SO ./textures/bluestone.xpm
WE ./textures/mossy.xpm
EA ./textures/redstone.xpm
F 192,192,192
C 105,105,105
11111111
10100001
10100001
10000001
100N0001
10001001
10000001
11111111


