NO ./textures/bluestone.xpm
SO ./textures/redstone.xpm
WE ./textures/purplestone.xpm
EA ./textures/greystone.xpm
F 192,192,192
C 105,105,105

      11111
      10001
      10001
      10001
      10001
      10001
      10001
      10001
      10001
      10001
      10001
      10001
      10001
     111D111
11111100000111111
10000000000000001
1000000000000000111111111111
1000000000000000010000000001
10000000000000000D0000000001
1000000000000000010000000001
1000000000000000111100001111
10000000000000001  110011
11111100000111111   1001
     111D111        1001
      10001         1001
      10001         1001
      10001         1001 111111111
      10001         100111010101011
      10001         100100000000001
      10P01         100D00000000001
      10001         100100000000001
      10001         111111010101011
      10001              111111111
      10001
      10001
 1111111D1111111
 100001000100001
 10000D000D00001
 100001000100001
 100001000100001
 111111000111111
 100001000100001
 1E000D000D00001
 100001000100001
 111111000111111
 100000000000001
 10P000000000P01
 100000000000001
 111111111111111


